#########################
#S..#5.53...#.....#.5.#.#
###.#5###.#.#.###.#.#.#.#
#.#.#.#...#5..#...3.#..5#
#.#.###.###############5#
#.#.3.#...#..335....#...#
#.###5#.#.#.#####3#.###.#
#....3#5#.3.#...#.#...#.#
#.###########.#.#####.#.#
#.#.5.........#.3...#.#.#
#.#####.###########.#.###
#.......#.#....5#...#..3#
#########3#.###.#.#####.#
#...........#5#..3#..3..#
#.###########.#######.#.#
#..35.....5...........#G#
#########################
