#####################
#S....#.............#
#.###.#.###########.#
#...#.#.....#.....#.#
###.#.#####.#.###.#.#
#...#.....#.#.#...#.#
#.#######.#.#.#.###.#
#.......#.#...#.....#
#.#####.#.#########.#
#.....#.#.........#.#
#####.#.#########.#.#
#.....#.........#.#.#
#.#############.#.#.#
#...............#..G#
#####################
